###..###..#####...##
####..#..########...
.###...####..#####..
###..#..............
####.##@##..########
......##.......#####
###..###..####....##
####.#####..####.###
###..#..............
####.#####..########